1020 1020 1020 1020 1020 1020 1020 1020 1020 1020 1020 1020 1020 1020 1020 1020 1020 1020 1020 1020 1020 1020 1020 1020 1020 1020 1020 1020 1020 1020 1020 1020 1020 1020 1020 1020 1020 1020 1020 1020
1010 3000 3000 3000 3000 3000 3000 3000 3000 3000 3000 3000 3000 3000 3000 3000 3000 3000 3000 3000 3000 3000 3000 3000 3000 3000 3000 3000 3000 3000 3000 3000 3000 3000 3000 3000 3000 3000 3000 1030
1010 3000 3000 3000 3000 3000 3000 3000 3000 3000 3000 3000 3000 3100 3100 3000 3000 3000 3000 3000 3000 3000 3000 3000 3000 3000 3000 3000 3000 3000 3000 3000 3000 3000 3000 3000 3000 3000 3000 1030
1010 4110 4120 4121 4130 3000 3000 3000 3000 3000 3000 3000 3000 3200 3200 5010 5020 5020 5020 5020 5020 5020 5020 5030 3000 3003 3000 3000 3000 3000 3000 3000 3000 4110 4120 4120 4120 4120 4131 1030
1010 4212 4220 4230 3000 3000 3000 3000 3000 3000 3000 3000 3000 3000 3000 5010 5020 5231 5220 5221 5220 5211 5020 5030 3009 3000 3000 5010 5020 5020 5020 5030 3009 4010 4020 4020 4020 4020 4030 1030
1010 3201 3000 3000 3005 3001 5022 5022 5022 5022 5022 5022 3009 3000 3000 5210 5221 5230 6021 6021 6021 5210 5221 5230 3009 3000 3000 5210 5220 5221 5220 5230 3009 4010 4020 4020 4020 4020 4030 1030
1010 3000 3000 3000 3000 3002 6010 6102 6020 6020 6020 6030 3009 3000 3000 6021 6104 6021 6220 6000 6220 6021 6104 6021 3009 3000 3000 6011 6100 6022 6100 6031 3009 4210 4211 4020 4020 4020 4030 1030
1010 5023 5023 5023 5023 3009 6211 6200 6224 6224 6000 6231 3009 3210 3230 6220 6201 6220 3009 2001 3000 6220 6201 6220 3211 3230 3000 6210 6203 6000 6203 6230 3009 3000 4212 4220 4220 4211 4030 1030
1010 6120 6101 6101 6121 3009 2110 2120 2120 2120 2120 2120 2120 2120 2120 2120 2120 2120 2120 2120 2120 2120 2120 2120 2120 2120 2120 2120 2120 2120 2120 2130 3000 3003 3201 3003 3003 4210 4230 1030
1010 6221 6202 6202 6222 3009 2010 2020 2020 2020 2020 2020 2020 2020 2020 2020 2020 2020 2020 2020 2020 2020 2020 2020 2020 2020 2020 2020 2020 2020 2020 2030 3000 3000 3000 3003 3000 3000 3002 1030
1010 3000 3000 3000 3000 3000 2210 2220 2220 2220 2220 2220 2220 2220 2220 2220 2220 2220 2020 2020 2020 2220 2220 2220 2220 2220 2220 2220 2220 2220 2220 2230 3000 3000 3000 3000 3000 3000 3000 1030
1010 3000 3119 3129 3139 3000 3000 3000 3000 3000 3000 3000 3000 3000 3003 3000 3007 7200 2010 2020 2030 7200 3007 3000 4110 4120 4120 4120 4131 3102 3201 3201 3000 3000 3000 3000 3000 3000 3000 1030
1010 3119 3229 3029 3239 3000 3000 3000 3000 3000 3000 3000 3000 3000 3000 3000 3000 3000 2010 2020 2030 3000 3000 3000 4010 4231 4220 4211 4030 3102 3000 8110 5212 5224 5224 5213 5021 5031 3103 1030
1010 3213 3113 3039 3000 3000 3000 3000 3000 3000 3000 3000 3000 3000 3000 3000 3000 3000 2010 2020 2030 3000 3000 3000 4210 4230 3008 4210 4230 3102 3000 8010 6023 6024 6023 5212 5223 5232 3105 1030
1010 3019 3212 3231 1110 3104 5010 6021 6103 6103 6103 6021 5030 3104 1130 3000 3000 3201 2010 2020 2030 3201 3000 3005 3000 3000 3000 3000 3000 3201 3000 8010 6223 6225 6226 6023 6023 6023 3105 1030
1010 3019 3029 3039 1000 3201 5010 6220 6204 6204 6204 6220 5030 3201 1000 3000 3000 3000 2010 2020 2030 3000 3000 3000 3000 3000 3000 3000 3000 3000 3000 8010 3001 3006 3002 6223 6000 6226 3202 1030
1010 3019 3029 3039 1000 3000 5210 5220 5220 5220 5220 5220 5230 3009 1000 3000 3000 3000 2010 2020 2030 3000 3000 3000 3000 3000 3000 3000 3000 3000 3000 8210 8220 8220 8211 3000 3000 3000 8030 1030
1010 3019 3212 3232 1000 3000 6021 6104 6021 6021 6021 6104 6021 3009 1000 3000 3000 7200 2010 2020 2030 7200 3000 3000 5024 5024 5024 5024 5024 3009 3000 8011 8020 8021 8210 3000 3000 3000 8230 1030
1010 3219 3039 3000 1000 3000 3106 6205 6220 6000 6220 6205 3106 3009 1000 3000 3000 2110 2020 2020 2020 2130 3000 3000 5024 5024 5024 5024 5024 3009 3000 8212 8021 8020 8011 7000 7000 7000 8021 1030
1010 3000 3029 3000 1000 3000 3201 3000 3000 2001 3000 3000 3201 3000 1000 3201 2110 2020 2020 2020 2020 2020 2130 3201 6120 6101 6120 6101 6121 3009 3000 3000 3000 3000 8212 7000 7000 7000 8020 1030
1010 3000 3210 3230 1210 1220 1220 1220 1211 2001 1231 1220 1220 1220 1230 2110 2020 2020 2020 2220 2020 2020 2020 2130 6221 6202 6000 6202 6222 3211 3230 3000 3000 3000 3000 3000 3000 3000 3000 1030
1010 3000 3000 3000 3003 3000 2110 2120 2120 2120 2120 2120 2120 2120 2120 2020 2020 2020 2230 3000 2210 2020 2020 2020 2120 2120 2120 2120 2120 2120 2120 2130 3000 3000 3000 3003 3000 3000 3000 1030
1010 3000 3002 3000 3000 3000 2010 2020 2020 2020 2020 2020 2020 2020 2020 2020 2020 2030 3000 3000 3000 2010 2020 2020 2020 2020 2020 2020 2020 2020 2020 2030 3000 3000 3000 3000 3000 3000 3000 1030
1010 3000 3000 3003 3000 3000 2210 2220 2220 2220 2220 2220 2220 2220 2220 2020 2020 2020 2130 3000 2110 2020 2020 2020 2220 2220 2220 2220 2220 2220 2220 2230 3000 3000 3000 3000 3000 3210 3230 1030
1010 3000 3000 3000 3000 3000 3000 3000 3000 3000 3000 3000 3000 3000 3000 2210 2020 2020 2020 2120 2020 2020 2020 2230 3000 3000 3000 3000 3000 3000 3000 3000 3000 3000 3000 3000 3000 3000 3000 1030
1010 3003 3000 3000 3000 3000 3000 3000 3000 3000 3000 3000 3000 3000 3000 3000 2210 2020 2020 2020 2020 2020 2230 3000 3000 3000 3000 3000 3000 3000 5012 6010 6102 6030 5012 5020 5032 5032 3009 1030
1010 3000 3000 3000 3000 5012 5020 5020 5020 5020 5020 5020 5020 5020 5020 5032 3000 2210 2020 2020 2020 2230 3000 3000 3000 3000 3000 3000 3000 3000 5012 6211 6200 6231 5012 5020 5032 5032 3009 1030
1010 3119 3139 3000 3000 5012 5020 5233 5225 5225 5226 5225 5225 5215 5020 5032 3009 7200 2010 2020 2030 7200 3000 3000 3000 3000 3000 3000 3000 3000 5214 5225 5225 5215 5012 5020 5032 5032 3009 1030
1010 3019 3029 3139 3000 5012 5020 5032 6010 6102 6020 6102 6030 5012 5020 5032 3009 3000 2010 2020 2030 3000 3000 3000 3000 3000 3000 3000 3000 3000 6010 6020 6030 5012 5012 5020 5032 5032 3009 1030
1010 3213 3113 3039 3100 5214 5226 5234 6211 6200 6000 6200 6231 5214 5226 5234 3009 3000 2010 2020 2030 3000 3000 3000 3000 5023 5023 5023 3009 3000 6211 6000 6231 5012 5214 5225 5234 5032 3009 1030
1010 3019 3212 3231 3200 6010 6102 6030 3009 2110 2120 2130 3000 6010 6102 6030 3009 3000 2010 2020 2030 3000 3000 3000 3001 6120 6121 6121 3009 3000 3000 2001 3000 5012 6010 6102 6030 5032 3009 1030
1010 3019 3029 3039 3000 6211 6201 6231 3009 2010 2020 2030 3000 6211 6201 6231 3009 3000 2010 2020 2030 3000 3000 3000 3002 6221 6000 6222 3009 3000 3000 3000 3000 5012 6211 6200 6231 5032 3009 1030
1010 3213 3233 3029 3139 3000 2110 2120 2120 2020 2020 2020 2120 2120 2120 2120 2120 2120 2020 2020 2020 2120 2120 2120 2120 2120 2120 2120 2120 2120 2120 2130 3000 5214 5225 5225 5225 5234 3009 1030
1010 3019 3029 3029 3039 3000 2010 2020 2020 2020 2020 2020 2020 2020 2020 2020 2020 2020 2020 2020 2020 2020 2020 2020 2020 2020 2020 2020 2020 2020 2020 2030 3000 6010 6102 6020 6102 6030 3009 1030
1010 3219 3229 3212 3232 3000 2210 2220 2220 2220 2220 2220 2220 2220 2220 2220 2220 2220 2020 2020 2020 2220 2220 2220 2220 2220 2220 2220 2220 2220 2220 2230 3201 6211 6200 6224 6200 6231 3009 1030
1010 4122 4122 4122 4122 4122 4122 4122 4122 4122 4122 4122 4122 4122 4122 4122 4122 4122 2010 2020 2030 4122 4122 4122 4122 4122 4122 4122 4122 4122 4122 4122 4122 4122 4122 4122 4122 4122 4122 1030
1010 4021 4021 4021 4021 4021 4021 4021 4021 4021 4021 4021 4021 4021 4021 4021 4021 4021 2010 2020 2030 4021 4021 4021 4021 4021 4021 4021 4021 4021 4021 4021 4021 4021 4021 4021 4021 4021 4021 1030
1010 4021 4021 4021 4021 4021 4021 4021 4021 4021 4021 4021 4021 4021 4021 4021 4021 4021 2010 2020 2030 4021 4021 4021 4021 4021 4021 4021 4021 4021 4021 4021 4021 4021 4021 4021 4021 4021 4021 1030
1020 1020 1020 1020 1020 1020 1020 1020 1020 1020 1020 1020 1020 1020 1020 1020 1020 1011 2020 2020 2020 1031 1020 1020 1020 1020 1020 1020 1020 1020 1020 1020 1020 1020 1020 1020 1020 1020 1020 1020
1020 1020 1020 1020 1020 1020 1020 1020 1020 1020 1020 1020 1020 1020 1020 1020 1020 1011 2020 2020 2020 1031 1020 1020 1020 1020 1020 1020 1020 1020 1020 1020 1020 1020 1020 1020 1020 1020 1020 1020