9999 9999 9999 9999 9999 9999 9999 9999 9999 9999 9999 9999 9999 9999 9999 9999 9999 9999 9999 9999 9999 9999 9999 9999 9999 9999 9999 9999 9999 9999 9999 9999 9999 9999 9999 9999 9999 9999 9999 9999
9999 0000 0000 0000 0000 0000 0000 0000 0000 0000 0000 0000 0000 0000 0000 0000 0000 0000 0000 0000 0000 0000 0000 0000 0000 0000 0000 0000 0000 0000 0000 0000 0000 0000 0000 0000 0000 0000 0000 9999
9999 0000 0000 0000 0000 0000 0000 0000 0000 0000 0000 0000 0000 9999 9999 5110 5120 5120 5120 5120 5120 5120 5120 5130 0000 0000 0000 0000 0000 0000 0000 0000 0000 0000 0000 0000 0000 0000 0000 9999
9999 9999 9999 9999 9999 0000 0000 0000 0000 0000 0000 0000 0000 9999 9999 9999 9999 9999 9999 9999 9999 9999 9999 9999 0000 0000 0000 5110 5122 5120 5120 5130 0000 9999 9999 9999 9999 9999 9999 9999
9999 9999 9999 9999 0000 0000 5123 5124 5123 5123 5123 5123 0000 0000 0000 9999 9999 9999 9999 9999 9999 9999 9999 9999 0000 0000 0000 9999 9999 9999 9999 9999 0000 9999 9999 9999 9999 9999 9999 9999
9999 9999 0000 0000 0000 9999 9999 9999 9999 9999 9999 9999 0000 0000 0000 9999 9999 9999 9999 9999 9999 9999 9999 9999 0000 0000 0000 9999 9999 9999 9999 9999 0000 9999 9999 9999 9999 9999 9999 9999
9999 5125 5125 5125 5125 9999 9999 9999 9999 9999 9999 9999 0000 3110 3130 9999 9999 9999 9999 9999 9999 9999 9999 9999 3110 3130 0000 9999 9999 9999 9999 9999 0000 9999 9999 9999 9999 9999 9999 9999
9999 9999 9999 9999 9999 0000 9999 9999 9999 9999 9999 9999 0000 9999 9999 9999 9999 9999 0000 0000 0000 9999 9999 9999 9999 9999 0000 9999 9999 9999 9999 9999 0000 0000 9999 9999 9999 9999 9999 9999
9999 9999 9999 9999 9999 0000 0000 0000 0000 0000 0000 0000 0000 0000 0000 0000 0000 0000 0000 0000 0000 0000 0000 0000 0000 0000 0000 0000 0000 0000 0000 0000 0000 0000 9999 9999 0000 9999 9999 9999
9999 9999 9999 9999 9999 0000 0000 0000 0000 0000 0000 0000 0000 0000 0000 0000 0000 7100 0000 0000 0000 7100 0000 0000 0000 0000 0000 0000 0000 0000 0000 0000 0000 0000 0000 0000 0000 0000 0000 9999
9999 0000 0000 0000 0000 0000 0000 0000 0000 0000 0000 0000 0000 0000 0000 0000 0000 7001 0000 0000 0000 7001 0000 0000 0000 0000 0000 0000 0000 3101 3101 3101 5111 5121 5121 5121 5121 5131 0000 9999
9999 0000 0000 0000 0000 0000 0000 5110 5120 5120 5120 5130 0000 0000 0000 104 0000 0000 0000 0000 0000 0000 0000 0000 9999 9999 9999 9999 9999 9999 9999 9999 5011 5021 5021 5021 5021 5031 0000 9999
9999 3110 3130 0000 0000 0000 0000 5010 5020 5020 5020 5030 0000 0000 0000 0000 0000 0000 0000 0000 0000 0000 0000 0000 9999 9999 9999 9999 9999 9999 0000 0000 9999 9999 9999 9999 9999 9999 9999 9999
9999 9999 9999 3130 0000 0000 5110 5210 5220 5221 5220 5230 5130 0000 0000 0000 0000 3101 0000 0000 0000 3101 0000 0000 9999 9999 9999 9999 9999 9999 0000 0000 9999 9999 9999 9999 9999 9999 9999 9999
9999 0000 9999 9999 9999 9999 9999 9999 9999 9999 9999 9999 9999 9999 9999 0000 0000 9999 0000 0000 0000 9999 0000 0000 0000 0000 0000 0000 0000 9999 0000 0000 9999 9999 9999 9999 9999 9999 9999 9999
9999 0000 0000 0000 9999 9999 9999 9999 9999 9999 9999 9999 9999 9999 9999 0000 0000 7100 0000 0000 0000 7100 0000 0000 0000 0000 0000 0000 0000 0000 0000 0000 9999 9999 9999 9999 9999 9999 9999 9999
9999 0000 3110 3130 9999 0000 9999 9999 9999 9999 9999 9999 9999 0000 9999 0000 0000 7001 0000 0000 0000 7001 0000 0000 5220 5220 5220 5220 5220 0000 0000 0000 0000 0000 0000 0000 0000 0000 0000 9999
9999 0000 9999 9999 9999 0000 9999 9999 9999 9999 9999 9999 9999 0000 9999 0000 0000 9999 0000 0000 0000 9999 0000 0000 9999 9999 9999 9999 9999 0000 0000 9999 9999 9999 0000 0000 0000 0000 0000 9999
9999 0000 0000 0000 9999 0000 9999 9999 9999 9999 9999 9999 9999 0000 9999 3101 0000 0000 0000 0000 0000 0000 0000 3101 9999 9999 9999 9999 9999 0000 0000 9999 9999 9999 9999 0000 0000 0000 9999 9999
9999 0000 3110 3130 9999 0000 9999 0000 0000 0000 0000 0000 9999 0000 9999 9999 0000 0000 0000 0000 0000 0000 0000 9999 9999 9999 9999 9999 9999 3110 3130 0000 0000 0000 9999 0000 0000 0000 9999 9999
9999 0000 9999 9999 9999 9999 9999 9999 9999 9999 0000 9999 9999 9999 9999 0000 0000 0000 0000 0000 0000 0000 0000 0000 9999 9999 9999 9999 9999 9999 9999 0000 0000 0000 0000 0000 0000 0000 0000 9999
9999 0000 0000 0000 0000 0000 0000 0000 0000 0000 0000 0000 0000 0000 0000 0000 0000 0000 0000 0000 0000 0000 0000 0000 0000 0000 0000 0000 0000 0000 0000 0000 0000 0000 0000 0000 0000 0000 0000 9999
9999 0000 0000 0000 0000 0000 0000 0000 0000 0000 0000 0000 0000 0000 0000 0000 0000 0000 0000 0000 0000 0000 0000 0000 0000 0000 0000 0000 0000 0000 0000 5112 5126 5126 5126 5126 5132 3110 3130 9999
9999 0000 0000 0000 0000 0000 0000 0000 0000 0000 0000 0000 0000 0000 0000 0000 0000 0000 0000 0000 0000 0000 0000 0000 0000 0000 0000 0000 0000 0000 0000 5012 5020 5020 5020 5020 5032 9999 9999 9999
9999 0000 0000 0000 0000 0000 0000 3110 3130 0000 0000 0000 0000 0000 0000 0000 0000 0000 0000 0000 0000 0000 0000 0000 0000 0000 0000 0000 0000 0000 5112 5214 5225 5225 5215 5020 5032 5132 0000 9999
9999 0000 0000 0000 0000 5112 5126 5126 5126 5126 5126 5126 5126 5126 5126 5132 0000 7100 0000 0000 0000 7100 0000 0000 0000 101 0000 0000 0000 0000 9999 9999 9999 9999 9999 9999 9999 9999 0000 9999
9999 0000 0000 0000 0000 9999 9999 9999 9999 9999 9999 9999 9999 9999 9999 9999 0000 7001 0000 0000 0000 7001 0000 0000 0000 0000 0000 0000 0000 0000 9999 9999 9999 9999 9999 9999 9999 9999 0000 9999
9999 0000 0000 0000 0000 9999 9999 9999 9999 9999 9999 9999 9999 9999 9999 9999 0000 9999 0000 0000 0000 9999 0000 0000 0000 0000 0000 0000 0000 0000 9999 9999 9999 9999 9999 9999 9999 9999 0000 9999
9999 3110 3130 0000 0000 9999 9999 9999 9999 9999 9999 9999 9999 9999 9999 9999 0000 0000 0000 0000 0000 0000 0000 0000 0000 5125 5125 5125 0000 0000 9999 9999 9999 9999 9999 9999 9999 9999 0000 9999
9999 9999 9999 3130 9999 9999 9999 9999 9999 9999 9999 9999 9999 9999 9999 9999 0000 0000 0000 0000 0000 0000 0000 0000 0000 9999 9999 9999 0000 0000 9999 9999 9999 9999 9999 9999 9999 9999 0000 9999
9999 0000 9999 9999 9999 9999 9999 9999 9999 0000 0000 0000 9999 9999 9999 9999 0000 103 0000 0000 0000 0000 0000 0000 9999 9999 9999 9999 0000 0000 0000 0000 9999 9999 9999 9999 9999 9999 0000 9999
9999 3110 3130 0000 0000 9999 9999 9999 0000 0000 0000 0000 0000 9999 9999 9999 0000 0000 0000 0000 0000 0000 0000 0000 9999 9999 9999 9999 0000 0000 0000 0000 0000 9999 9999 9999 9999 9999 0000 9999
9999 9999 9999 0000 0000 0000 0000 0000 0000 0000 0000 0000 0000 0000 0000 0000 0000 0000 0000 0000 0000 0000 0000 0000 0000 0000 0000 0000 0000 0000 0000 0000 0000 9999 9999 9999 9999 9999 0000 9999
9999 0000 0000 3110 3130 0000 0000 0000 0000 0000 0000 0000 0000 0000 0000 0000 0000 0000 0000 0000 0000 0000 0000 0000 0000 0000 0000 0000 0000 0000 0000 0000 3101 9999 9999 9999 9999 9999 3101 9999
9999 0000 0000 9999 9999 0000 0000 0000 0000 0000 0000 0000 0000 0000 0000 0000 102 0000 0000 0000 0000 0000 0000 0000 0000 0000 0000 0000 0000 0000 0000 0000 9999 9999 9999 9999 9999 9999 9999 9999
9999 9999 9999 9999 9999 9999 9999 9999 9999 9999 9999 9999 9999 9999 9999 9999 9999 9999 109 110 0000 9999 9999 9999 9999 9999 9999 9999 9999 9999 9999 9999 9999 9999 9999 9999 9999 9999 9999 9999
9999 9999 9999 9999 9999 9999 9999 9999 9999 9999 9999 9999 9999 9999 9999 9999 9999 9999 0000 0000 0000 9999 9999 9999 9999 9999 9999 9999 9999 9999 9999 9999 9999 9999 9999 9999 9999 9999 9999 9999
9999 9999 9999 9999 9999 9999 9999 9999 9999 9999 9999 9999 9999 9999 9999 9999 9999 9999 0000 0000 0000 9999 9999 9999 9999 9999 9999 9999 9999 9999 9999 9999 9999 9999 9999 9999 9999 9999 9999 9999
9999 9999 9999 9999 9999 9999 9999 9999 9999 9999 9999 9999 9999 9999 9999 9999 9999 9999 0000 0000 0000 9999 9999 9999 9999 9999 9999 9999 9999 9999 9999 9999 9999 9999 9999 9999 9999 9999 9999 9999
9999 9999 9999 9999 9999 9999 9999 9999 9999 9999 9999 9999 9999 9999 9999 9999 9999 9999 0000 0000 0000 9999 9999 9999 9999 9999 9999 9999 9999 9999 9999 9999 9999 9999 9999 9999 9999 9999 9999 9999